NO ./assets/textures/wall1.xpm ./assets/textures/wall1.xpm ./assets/textures/wall2.xpm ./assets/textures/wall2.xpm ./assets/textures/wall3.xpm ./assets/textures/wall3.xpm
SO ./assets/textures/wall2.xpm ./assets/textures/wall2.xpm ./assets/textures/wall3.xpm ./assets/textures/wall3.xpm ./assets/textures/wall4.xpm ./assets/textures/wall4.xpm
WE ./assets/textures/wall3.xpm ./assets/textures/wall3.xpm ./assets/textures/wall4.xpm ./assets/textures/wall4.xpm ./assets/textures/wall1.xpm ./assets/textures/wall1.xpm
EA ./assets/textures/wall4.xpm ./assets/textures/wall4.xpm ./assets/textures/wall1.xpm ./assets/textures/wall1.xpm ./assets/textures/wall2.xpm ./assets/textures/wall2.xpm

F 0,0,100
C 225,220,0

        1111111111111111111111111   11111111111111111111111111111111111111111
        1000000000110000000000001   10000000000000000000000000000000000000001
        1011000001110000000000001   10000000000000000000000000000000000000001
        1001000000000000000000001   10000000000000000000000000000000000000001
111111111011000001110000000000001   10000000000000000000000000000000000000001                
10000000001100000111011111111111111110000000000000111111111000000000000000001                
11110111111111N11100000010000000000000000000000000     0  1000000000000000001               
11110111111111011101010010001111111110000000000000111111111000000000000000001
11000000110101011100000000001       10000000000000000000000000000000000000001
10000000000000001100000010001  1111110000000000000000000000000000000000000001
10000000000000001101010010001       10000000000000000000000000000000000000001
1100000111010101111101111001111111  11111111111111111111111111111111111111111
11110111 1110101 101111010001
11111111 1111111 111111111111  