NO ./assets/textures/fancy_north.xpm
SO ./assets/textures/fancy_south.xpm
WE ./assets/textures/fancy_west.xpm
EA ./assets/textures/fancy_east.xpm

F 0,0,100
C 225,220,0

        1111111111111111111111111   111111111
        1000000000110000000000001   100000001
        1011000001110000000000001   100000001
        1001000000000000000000001   100000001
111111111011000001110000000000001   100000001
100000000011000001110111111111111111100000001
111101111111110111000000100000000000000N00001
111101111111110111010100100011111111100000001
11000000110101011100000000001       100000001
10000000000000001100000010001       100000001
10000000000000001101010010001       100000001
110000011101010111110111100111      111111111
11110111 1110101 101111010001
11111111 1111111 111111111111                     



